Welcome to the interactive adventure of Dracula. The Count has recently begun his conquest of England in London.  It is up to you, as Johnathan Harker, to find a way to banish the Count and force him to retreat to Transylvania. It is imperative that you work as quick as possible.  "Denn die Todten reiten Schnell."~For the dead travel fast 

 At any point in the game, typing "help" will bring up a list of commands at your disposal
English Project
An Interactive Fiction by Cory Brzyck
Release 1 / Serial number 131014 / Inform 7 build 6G60 (I6/v6.32 lib 6/12N) SD

Asylum Atrium
You notice Mina working hard a typewriter and Seward squinting at your journal. Van Helsing sits in the back, staring at the ceiling. To the south you see a heavy door leading out of the Asylum. You can hear rustling coming from the room to west

You can see Asylum Door, Mina and Seward here.

>e
(first opening the Asylum Door)
It seems to be locked.

* * *

>e
Study
This room is full fo books and shelves. You notice a shipping log sitting on the desk

You can see Seward's Desk (on which is a shipping log) here.

>read shipping log
You pick up the shipping log and begin to read.
You take note  of fifty crates that have been shipped to England from Translyvania. It appears that they were all delivered to the chapel Carafax next door.

>w
Van Helsing steps forward and begins to address the group: "There are such beings as vampires, some of us have evidence that they exist. Even had we not the proof of our own unhappy experience, the teachings and the records of the past give proof enough for sane peoples. I admit that at the first I was sceptic. Were it not that through long years I have trained myself to keep an open mind, I could not have believed until such time as that fact thunder on my ear.`See! See! I prove, I prove." Alas! Had I known at first what now I know, nay, had I even guess at him, one so precious life had been spared to many of us who did love her. But that is gone, and we must so work, that other poor souls perish not, whilst we can save. The nosferatu do not die like the bee when he sting once. He is only stronger, and being stronger, have yet more power to work evil. This vampire which is amongst us is of himself so strong in person as twenty men, he is of cunning more than mortal, for his cunning be the growth of ages, he have still the aids of necromancy, which is, as his etymology imply, the divination by the dead, and all the dead that he can come nigh to are for him at command, he is brute, and more than brute, he is devil in callous, and the heart of him is not, he can, within his range, direct the elements, the storm, the fog, the thunder, he can command all the meaner things, the rat, and the owl, and the bat, the moth, and the fox, and the wolf, he can grow and become small, and he can at times vanish and come unknown. How then are we to begin our strike to destroy him? How shall we find his where, and having found it, how can we destroy? My friends, this is much, it is a terrible task that we undertake, and there may be consequence to make the brave shudder. For if we fail in this our fight he must surely win, and then where end we? Life is nothings, I heed him not. But to fail here, is not mere life or death. It is that we become as him, that we henceforward become foul things of the night like him, without heart or conscience, preying on the bodies and the souls of those we love best. To us forever are the gates of heaven shut, for who shall open them to us again? We go on for all time abhorred by all, a blot on the face of God's sunshine, an arrow in the side of Him who died for man. But we are face to face with duty, and in such case must we shrink? For me, I say no, but then I am old, and life, with his sunshine, his fair places, his song of birds, his music and his love, lie far behind. You others are young. Some have seen sorrow, but there are fair days yet in store. What say you?"

* * *

>e
(first opening the Asylum Door)
It seems to be locked.

>read shipping log
You pick up the shipping log and begin to read.
You take note  of fifty crates that have been shipped to England from Translyvania. It appears that they were all delivered to the chapel Carafax next door.

>w
Van Helsing steps forward and begins to address the group: "It  is our duty to drive this vampire back to his home. I know it will not be easy, he can take the form of any animal and is stronger than all of us put together. He is also smart. No matter the cost, we must  band together to create a brighter tomorrow." 

 Seward walks over to the door to the South and unlocks it

* * *

>e
(first opening the Asylum Door)
It seems to be locked.

>s
Study
This room is full of books and shelves. You notice a shipping log sitting on the desk

You can see Seward's Desk (on which is a shipping log) here.

>destroy shipping log iwth holy wafer
I only understood you as far as wanting to destroy the shipping log.

* * *

>w
You can't go that way.

>e
You can't go that way.

>read shipping log
You pick up the shipping log and begin to read.
You take note  of fifty crates that have been shipped to England from Translyvania. It appears that they were all delivered to the chapel Carafax next door.

>n
Van Helsing steps forward and begins to address the group: "It  is our duty to drive this vampire back to his home. I know it will not be easy, he can take the form of any animal and is stronger than all of us put together. He is also smart. No matter the cost, we must  band together to create a brighter tomorrow." 

 Seward walks over to the door to the South and unlocks it

>destory seward with holy wafer
That's not a verb I recognise.

>destory seward with holy wafer
That's not a verb I recognise.

* * *

>x seward
You see nothing special about Seward.

* * *

>s
Study
This room is full of books and shelves. You notice a shipping log sitting on the desk

You can see Seward's Desk (on which is a shipping log) here.

>destory shipping log with holy wafer
That's not a verb I recognise.

>destroy shipping log wit holy wafer
I only understood you as far as wanting to destroy the shipping log.

* * *

>r
That's not a verb I recognise.

>e
Study
This room is full fo books and shelves. You notice a shipping log sitting on the desk

You can see Seward's Desk (on which is a shipping log) here.

* * *

>read shipping log
You pick up the shipping log and begin to read.
You take note  of fifty crates that have been shipped to England from Translyvania. It appears that they were all delivered to the chapel Carafax next door.

>w
Van Helsing steps forward and begins to address the group: "It  is our duty to drive this vampire back to his home. I know it will not be easy, he can take the form of any animal and is stronger than all of us put together. He is also smart. No matter the cost, we must  band together to create a brighter tomorrow."
\nSeward walks over to the door to the South and unlocks it

* * *

>help
Use N to move North, S to move South, E to move East, W to move West. 
 Use "read" <object> to attempt to read something.

>e
Study
This room is full fo books and shelves. You notice a shipping log sitting on the desk

You can see Seward's Desk (on which is a shipping log) here.

* * *

>w
Van Helsing steps forward and begins to address the group: "It  is our duty to drive this vampire back to his home. I know it will not be easy, he can take the form of any animal and is stronger than all of us put together. He is also smart. No matter the cost, we must  band together to create a brighter tomorrow." 

 Seward walks over to the door to the South and unlocks it

>s
You can't go that way.

* * *

>he;[
That's not a verb I recognise.

>help
adhsfkjahdsfjadklsf.

* * *

>s
Study
This room is full of books and shelves. You notice a shipping log sitting on the desk

You can see Seward's Desk (on which is a shipping log) here.

>w
You can't go that way.

* * *

>s
Study
This room is full of books and shelves. You notice a shipping log sitting on the desk

You can see Seward's Desk (on which is a shipping log) here.

>s
(first opening the Asylum Door)
It seems to be locked.

>s
(first opening the Asylum Door)
It seems to be locked.

* * *

>s
Study
This room is full of books and shelves. You notice a shipping log sitting on the desk

You can see Seward's Desk (on which is a shipping log) here.

>read shipping log
You pick up the shipping log and begin to read.
You take note  of fifty crates that have been shipped to England from Translyvania. It appears that they were all delivered to the chapel Carafax next door.

>n
Van Helsing steps forward and begins to address the group: "It  is our duty to drive this vampire back to his home. I know it will not be easy, he can take the form of any animal and is stronger than all of us put together. He is also smart. No matter the cost, we must  band together to create a brighter tomorrow." 

 Seward walks over to the door to the East and unlocks it 

 Morris, Holmwood, and Van Helsing exit the Asylum to head for Carfax

>e
(first opening Asylum Door)

Essex Purfleet
A sprawling road that leads north to the Carfax. Dracula's choice of location is odd considering its proximity to the Asylum. Hopefully we can be one step ahead of him for once.

You can see Asylum Door here.

>look
Essex Purfleet
You can see an Asylum Door here.

>n
Carfax
You count 29 boxes in the room

You can see 29 box of earth here.

>destory 29 box of earth with holy wafer
That's not a verb I recognise.

>destroy 29 box of earth with holy wafer
I only understood you as far as wanting to destroy 29 box of earth.

* * *

>look
Carfax
You count 29 boxes in the room

You can see 29 box of earth here.

* * *

>e
(first opening Asylum Door)

Essex Purfleet
A sprawling road that leads north to the Carfax. Dracula's choice of location is odd considering its proximity to the Asylum. Hopefully we can be one step ahead of him for once.

You can see Asylum Door here.

>n
You see a lot of boxes in the room, you're unsure of how many there are. There is an overwhelming stench in the chapel that would normally have lead you to leave. As you and your allies begin to take a step toward them the room begins to fill with rats! 

 You take a quick survey of what everyone has with them. 
     Van Helsing has a cross and holy wafers with him. 
     Seward only has keys with him. 
     Holmwood has a silver whistle with him. 
     Morris has his pistol with him.

>look
Carfax
You can see a box of earth here.

>destory box of earth with holy wafer
That's not a verb I recognise.

* * *

>look
Carfax
You can see a box of earth here.

>take box of earth
Taken.

>look
Carfax

* * *

>n
You see a lot of boxes in the room, you're unsure of how many there are. There is an overwhelming stench in the chapel that would normally have lead you to leave. As you and your allies begin to take a step toward them the room begins to fill with rats! 

 You take a quick survey of what everyone has with them. 
     Van Helsing has a cross and holy wafers with him. 
     Seward only has keys with him. 
     Holmwood has a silver whistle with him. 
     Morris has his pistol with him.

>take box of earth
You can't see any such thing.

>look
Carfax

>place box of earth
That's not a verb I recognise.

>drop box of earth
Dropped.

>look
Carfax
You can see 29 Box of earth here.

* * *

>take box of earth
You can't see any such thing.

>take baoxes of earth
You can't see any such thing.

* * *

>n
You see a lot of boxes in the room, you're unsure of how many there are. There is an overwhelming stench in the chapel that would normally have lead you to leave. As you and your allies begin to take a step toward them the room begins to fill with rats! 

 You take a quick survey of what everyone has with them. 
     Van Helsing has a cross and holy wafers with him. 
     Seward only has keys with him. 
     Holmwood has a silver whistle with him. 
     Morris has his pistol with him.

>ask morris for pistol
You must supply a noun.

>ask morris about pistol
I don't think using a pistol is a good idea here

* * *

>ask morris for pistol
You must supply a noun.

>take pistol
asfasf
That seems to belong to Morris.

>ask morris about pistol
There is no reply.

* * *

>ask morris about pistol
I don't think using a pistol is a good idea here

* * *

>ask morris for pistol
You must supply a noun.

>ask morris for the pistol
You must supply a noun.

* * *

>n
You see a lot of boxes in the room, you're unsure of how many there are. There is an overwhelming stench in the chapel that would normally have lead you to leave. As you and your allies begin to take a step toward them the room begins to fill with rats! 

 You take a quick survey of what everyone has with them. 
     Van Helsing has a cross and holy wafers with him. 
     Seward only has keys with him. 
     Holmwood has a silver whistle with him. 
     Morris has his pistol with him.

>ask morris about pistol
Morris gives the pistol to you.

I don't think using a pistol is a good idea here

>ask morris for pistol
I don't think using a pistol is a good idea here

* * *

>ask morris for pistol
I don't think using a pistol is a good idea here

>x pistol
You see nothing special about the pistol.

>x pistol
You see nothing special about the pistol.

>take pistol from morris
That seems to belong to Morris.

>drop pistol
You haven't got that.

>ask morris about pistol
I don't think using a pistol is a good idea here

>drop pistol
You haven't got that.

* * *

>ask morris about pistol
Morris gives the pistol to you.

I don't think using a pistol is a good idea here

>drop pistol
Dropped.

>ask morris for pistol
(Morris first taking the pistol)
Morris gives the pistol to you.

I don't think using a pistol is a good idea here

>drop pistol
Dropped.

>take pistol
Taken.

>take pistol from morris
You can't see any such thing.

>shoot pistol
That's not a verb I recognise.

>x pistol
You see nothing special about the pistol.

>fire pistol
It probably isn't a good idea to fire that in here.

>take whistle from Holmwood
That seems to belong to Holmwood.

>ask holmwood for whistle
Holmwood gives the silver whistle to you.

I'm not sure what good it will be, but I think I did see some dogs around the neighborhood

>blow whistle
You hear low grumbles as a group of dogs run in and chase away the rats

Van Helsing walks around the room and places a holy wafer in each box.  (There are only 21 boxes left to take care of).

 You best return to the asylum and see if Mina has found out anything new.

>nlow whistle
That's not a verb I recognise.

>blow whistle
You hear low grumbles as a group of dogs run in and chase away the rats

Van Helsing walks around the room and places a holy wafer in each box.  (There are only 21 boxes left to take care of).

 You best return to the asylum and see if Mina has found out anything new.

>blow silver whistle
You hear low grumbles as a group of dogs run in and chase away the rats

Van Helsing walks around the room and places a holy wafer in each box.  (There are only 21 boxes left to take care of).

 You best return to the asylum and see if Mina has found out anything new.

* * *

>number left
I didn't understand that sentence.

>number of boxes left
21 boxes left to destroy

>s
Essex Purfleet
A sprawling road that leads north to the Carfax. Dracula's choice of location is odd considering its proximity to the Asylum. Hopefully we can be one step ahead of him for once.

You can see Asylum Door here.

>w
Mina runs over and tells you that she has found the locations of the remaining 21 boxes. 12 of them are located in the East End while the other 9 are at a house in Piccadilly. The group has decided to split up, you to go with Van Helsing to Piccadilly while Holmwood and Morris take care of the other boxes

>n
You can't go that way.

>l
Asylum Atrium
You notice Mina working hard a typewriter and Seward squinting at your journal. Van Helsing sits in the back, staring at the ceiling. To the south you see a heavy door leading out of the Asylum. You can hear rustling coming from the room to west

You can see Asylum Door and Mina here.

>w
You find that Renfield has had is neck snapped. Perhaps you aren't as far ahead of Dracula as you thought you were.

>e
Mina runs over and tells you that she has found the locations of the remaining 21 boxes. 12 of them are located in the East End while the other 9 are at a house in Piccadilly. The group has decided to split up, you to go with Van Helsing to Piccadilly while Holmwood and Morris take care of the other boxes

>e
Essex Purfleet
A sprawling road that leads north to the Carfax. Dracula's choice of location is odd considering its proximity to the Asylum. Hopefully we can be one step ahead of him for once.

You can see Asylum Door here.

* * *

>l
London Road

>help
Use N to move North, S to move South, E to move East, W to move West. 
Use "read" <object> to attempt to read something. 
Use "examine" or "x" to get a detailed description of a person or object.
Use "shoot" <object> to attempt to fire something. 
Use "blow" <object> to attempt to blow air through it. 
Use "Number of boxes left" to find out the number of boxes left to destroy.
Use "ask" <person> about/for <object> to try to receive an object from someone.

>w
Piccadilly

>s
Dracula's House